NO ./src/img/north_texture.xpm
SO ./src/img/south_texture.xpm
WE ./src/img/west_texture.xpm
EA ./src/img/east_texture.xpm

F 220,100,20
C 73,79,143

 11111111111111111111111 
1100000000110000000000011
1011000001110000000000001
1001000000000000000000001
1111111110110000011000001
1000000000110000011011111
1111011111111101110000001
1111011111111101110000001
1100000011000100110000001
1000000000000000110000001
100000000000S000110000001
1100000111000011111100011
 11111111111111111111111 