NO ./src/img/north_texture.xpm
SO ./src/img/south_texture.xpm
WE ./src/img/west_texture.xpm	
EA ./src/img/east_texture.xpm 

F 33,60,100
C 25,50,80

11111111111
10000000111
100100N0111
10010000001
11111111001
10000000001
11110111001
11111111111