NO ./path_to_the_north_texture
SO ./path_to_the_south_texture
WE ./path_to_the_west_texture
EA ./path_to_the_east_texture

F 220,100,20
C 225,30,0

          111111 1110001
        1000001   1011111100000001  
        1010000001110000000000001111
        1000000000000000000000001
111111111010000001110000000000001
100000000010000001110111111111111
111100000000000000011100000010001
111100000000000000011101010010001
11000000110101010000000010001
10000000000000000000000010001
10000000000000000001010010001111111
11000001110101011111011110N00000001
11110111 1110101 101111010001111111
11111111 1111111 111111111111