NO ./src/img/north_texture.xpm
SO ./src/img/south_texture.xpm
WE ./src/img/west_texture.xpm
EA ./src/img/east_texture.xpm

F 220,100,20
C 225,30,0

        1111111 11111111
        1000001111101111111111111  
        1010000001110000000000001111
        1000000000000000000000001
111111111010000001110000000000001
100000000010000001110111111111111
111100000000000000011100000010001
111100000000000000011101010010001
110000001101010100000000100011111
10000000000000000000000010001
10000000000000000001010010001111111
11000001110101011111011110N00000001
11110111 1110101 101111010001111111
11111111 1111111 111111111111