NO ./path_to_the_north_texture
SO ./path_to_the_south_texture
WE ./path_to_the_west_texture
EA ./path_to_the_east_texture

F 220,100,20
C 225,30,0

111111111111111111111111111111111
100000000011000000000000000000001
101100000111000000000000000000001
100100000              0000000001
100000001              0000000001
100000000              0000000001
111101111              0000010001
111101111              0010010001
110000001              0000010001
100000000              0000010001
100000000000000000010000010010001
11000001110101010000011110N000001
111111111111111111111111111111111
