NO ./path_to_the_north_texture
SO ./path_to_the_south_texture
WE ./path_to_the_west_texture
EA ./path_to_the_east_texture

F 220,100,20
C 225,30,0

11111111111
11000000011
10010000011
10010000001
11111111101
10000000001
11110111111
11111111111