NO ./path_to_the_north_texture
SO ./path_to_the_south_texture
WE ./path_to_the_west_texture
EA ./path_to_the_east_texture

F 220,100,20
C 225,30,0

1111111111111111111111111
1100000001110000000000001
1011000001110000000000001
1001000000000000000000001
1111111110110000011000001
1000000000110000011011111
1111011111111101110000001
1111011111111101110100001
1100000011010101110000001
1000000000000000110000001
100000000000S000011001001
1100000111010101111100001
1111111111111111111111111